8 12
223321332233
445566445566
            
223322332233
445566445566
            
223322332233
445566445586