111111111111111111111
1                   1
1    1        1     1
1                   1
1         1         1
1    1        1     1
1     1      1      1
1       1111        1
111111111111111111111