    1    9     1
    111111111111
            
    654321123456
    654321123456
            
    123456654321
    123456654321
       11111