223322332233
445566445566
            
223322332233
445566445566
            
223322332233
445566445586
111111111111